[
  {
    "type": "mapgen",
    "om_terrain": [ "orchard_processing" ],
    "weight": 500,
    "object": {
      "fill_ter": "t_metal_floor",
      "rows": [
        "qqqqqqqqqqqqqqqqqqqqqqqq",
        "q                      q",
        "q                      q",
        "q                      q",
        "q $$$$$$$$$$$$$$$$$$$$ q",
        "q $MMMMMMMMMMMMMMMMMM$ q",
        "q $M,,CMmmmmmmmmmOOYM$ q",
        "q $MCk,omEcccEmmmmOYM$ q",
        "q $MMx+MmmmmmmmmmOYYM$ q",
        "q $MmmmmmmmmmMM&&MMMM$ q",
        "q $MmmEmmmmmmMzmmmXXM$ q",
        "q $Mfmcmmmmmm&mmmmXXM$ q",
        "q $Mfmcmmmmmm&mmmmmXM$ q",
        "q $MfmcmmmmmmMmmmmXXM$ q",
        "q $MmmEmmmmmmMmmmmmXM$ q",
        "q $MmmmmmmmmmMmmmmGXM$ q",
        "q $MMMMMM&&MMM====MMM$ q",
        "q      ^$]]$]......]   q",
        "q 7$$7  $]]$]......]   q",
        "]]]]]]]]]]]]]......]   q",
        "]...........]......]   q",
        "]...........]......]   q",
        "]...........]......]   q",
        "]...........]......]   q"
      ],
      "palettes": [ "orchard_buildings" ],
      "items": {
        "O": { "item": "orchard_tools", "chance": 25, "repeat": [ 0, 1 ] },
        "X": { "item": "orchard_tools", "chance": 25, "repeat": [ 0, 1 ] },
        "Y": [ { "item": "orchard_tools", "chance": 50, "repeat": [ 1, 2 ] }, { "item": "orchard_supplies", "chance": 50 } ]
      },
      "place_items": [
        { "item": "office", "x": 7, "y": 7, "chance": 75, "repeat": [ 1, 3 ] },
        { "item": "office", "x": 16, "y": 10, "chance": 50 },
        { "item": "hardware", "x": 6, "y": [ 11, 13 ], "chance": 50, "repeat": [ 1, 2 ] }
      ],
      "place_monster": [
        { "group": "GROUP_PEST", "x": [ 1, 10 ], "y": [ 1, 10 ], "chance": 9 },
        { "group": "GROUP_SAFE", "x": [ 10, 20 ], "y": [ 10, 20 ], "chance": 6 },
        { "group": "GROUP_ZOMBIE", "x": [ 10, 22 ], "y": [ 10, 22 ], "chance": 6 },
        { "group": "GROUP_FUNGI_FLOWERS", "x": [ 10, 22 ], "y": [ 10, 22 ], "chance": 6 }
      ],
      "place_vehicles": [
        { "vehicle": "suburban_home", "x": [ 3, 8 ], "y": 22, "chance": 45, "rotation": 180 },
        { "vehicle": "parking_garage_short", "x": 15, "y": 20, "chance": 60, "rotation": -90 },
        { "vehicle": "forklift_vehicles", "x": 16, "y": 12, "chance": 20, "rotation": 90 }
      ]
    }
  },
  {
    "type": "mapgen",
    "om_terrain": [ "orchard_stall" ],
    "weight": 500,
    "object": {
      "fill_ter": "t_floor",
      "rows": [
        "].y.y.y.y.y.]......]   q",
        "...................]   q",
        "...................]   q",
        "...................]   q",
        "...................]****",
        "..................]]****",
        "..................]*****",
        "..................]*   q",
        ".................]]*   q",
        "................]]**   q",
        ".............]]]]**    q",
        "]]]]]]]]]]]]]]****     q",
        "q************^******   q",
        "q******bbb**WWWWWWW+WW q",
        "q******ttt**WcT{vvS,sW q",
        "q******bbb**oc,D,,,,FW q",
        "q***********oc,,,,,,FW q",
        "q***********WPOOa,,TFW q",
        "q ********* WWWWW++WWW q",
        "q7 ****btb 7WXOO,,,ffW q",
        "q  ****btb  WXO,,,,,gW q",
        "q7 ****btb 7WWW=====WW q",
        "q *********   g*****dd q",
        "qqqq***qqqqqqqq*****qqqq"
      ],
      "palettes": [ "orchard_buildings" ],
      "place_signs": [ { "signage": "Get Apples n Ciders!", "x": 13, "y": 17 } ],
      "place_items": [
        { "item": "fridge", "x": 20, "y": [ 15, 17 ], "chance": 25, "repeat": [ 1, 3 ] },
        { "item": "orchard_tools", "x": [ 19, 20 ], "y": 19, "chance": 50, "repeat": [ 1, 2 ] },
        { "item": "trash", "x": [ 20, 21 ], "y": 22, "chance": 65, "repeat": [ 1, 2 ] },
        { "item": "trash", "x": 15, "y": 15, "chance": 75 },
        { "item": "stored_pulp", "x": [ 13, 14 ], "y": [ 19, 20 ], "chance": 75 },
        { "item": "cash_register_random", "x": 13, "y": [ 14, 16 ], "chance": 100 }
      ],
      "place_item": [ { "item": "apple", "x": 20, "y": [ 15, 17 ], "chance": 100, "repeat": [ 5, 15 ] } ],
      "liquids": { "k": { "liquid": "apple_cider", "amount": [ 10, 100 ] } },
      "place_monster": [
        { "group": "GROUP_PEST", "x": [ 1, 22 ], "y": [ 1, 22 ], "chance": 10 },
        { "group": "GROUP_FARM_PESTS", "x": [ 1, 22 ], "y": [ 1, 22 ], "repeat": [ 1, 2 ], "chance": 20 },
        { "group": "GROUP_SAFE", "x": [ 1, 22 ], "y": [ 1, 22 ], "chance": 10 },
        { "group": "GROUP_DOMESTIC", "x": [ 1, 22 ], "y": [ 1, 22 ], "chance": 20 },
        { "group": "GROUP_ZOMBIE", "x": [ 1, 22 ], "y": [ 1, 22 ], "repeat": [ 1, 3 ], "chance": 25 }
      ],
      "place_vehicles": [ { "vehicle": "suburban_home", "x": 5, "y": 10, "chance": 45 } ]
    }
  },
  {
    "type": "mapgen",
    "om_terrain": [ "orchard_tree_apple" ],
    "weight": 100,
    "object": {
      "fill_ter": "t_region_soil",
      "rows": [
        "************************",
        "************************",
        "**         **         **",
        "** 7  7  7 ** 7  7  7 **",
        "**         **         **",
        "**         **         **",
        "** 7     7 ** 7     7 **",
        "**         **         **",
        "**         **         **",
        "** 7  7  7 ** 7  7  7 **",
        "**         **         **",
        "************************",
        "************************",
        "**         **         **",
        "** 7  7  7 ** 7  7  7 **",
        "**         **         **",
        "**         **         **",
        "** 7     7 ** 7     7 **",
        "**         **         **",
        "**         **         **",
        "** 7  7  7 ** 7  7  7 **",
        "**         **         **",
        "************************",
        "************************"
      ],
      "palettes": [ "orchard_tree_apple" ],
      "place_monster": [
        { "group": "GROUP_PEST", "x": [ 1, 10 ], "y": [ 1, 10 ], "chance": 9 },
        { "group": "GROUP_DOMESTIC", "x": [ 1, 10 ], "y": [ 1, 10 ], "chance": 6 },
        { "group": "GROUP_SAFE", "x": [ 10, 20 ], "y": [ 10, 20 ], "chance": 6 },
        { "group": "GROUP_ZOMBIE", "x": [ 10, 22 ], "y": [ 10, 22 ], "repeat": [ 1, 4 ], "chance": 7 },
        { "group": "GROUP_FUNGI_FLOWERS", "x": [ 6, 22 ], "y": [ 6, 22 ], "repeat": [ 1, 4 ], "chance": 4 }
      ]
    }
  },
  {
    "type": "mapgen",
    "om_terrain": [ "orchard_processing_roof" ],
    "object": {
      "fill_ter": "t_tile_flat_roof",
      "rows": [
        "                        ",
        "                        ",
        "                        ",
        "                        ",
        "                        ",
        "   ------------------   ",
        "   -................-   ",
        "   -.:...........7..-   ",
        "   -................-   ",
        "   -..9......###....-   ",
        "   -.........#v#....-   ",
        "   -.........###....-   ",
        "   -................-   ",
        "   -................-   ",
        "   -................-   ",
        "   -................-   ",
        "   ----5-------------   ",
        "                        ",
        "                        ",
        "                        ",
        "                        ",
        "                        ",
        "                        ",
        "                        "
      ],
      "palettes": [ "roof_palette" ],
      "terrain": { ".": "t_tile_flat_roof" }
    }
  },
  {
    "type": "mapgen",
    "om_terrain": [ "orchard_stall_roof" ],
    "weight": 500,
    "object": {
      "fill_ter": "t_tile_flat_roof",
      "rows": [
        "                        ",
        "                        ",
        "                        ",
        "                        ",
        "                        ",
        "                        ",
        "                        ",
        "                        ",
        "                        ",
        "                        ",
        "                        ",
        "                        ",
        "                        ",
        "            -5--------- ",
        "            -.........- ",
        "            -.......3.- ",
        "            -.........- ",
        "            -.......3.- ",
        "            -.........- ",
        "            -.........- ",
        "            -.........- ",
        "            ----------- ",
        "                        ",
        "                        "
      ],
      "palettes": [ "roof_palette" ],
      "terrain": { ".": "t_tile_flat_roof" }
    }
  }
]
