[
  {
    "type": "palette",
    "id": "farm_lab_palette_01",
    "terrain": {
      "a": [ [ "t_region_groundcover", 50 ], [ "t_region_groundcover_barren", 50 ] ],
      "b": "t_region_grass",
      "c": [ [ "t_mud", 80 ], [ "t_water_murky", 20 ] ],
      "d": "t_concrete",
      "e": "t_linoleum_white",
      "f": "t_door_c",
      "g": [ [ "t_door_b", 30 ], [ "t_door_c", 70 ] ],
      "Ø": "t_door_metal_locked",
      "Ð": "t_card_science",
      "h": "t_concrete_wall",
      "i": "t_concrete_wall",
      "j": "t_wall_w",
      "k": "t_linoleum_white",
      "l": "t_linoleum_white",
      "m": [ [ "t_region_groundcover", 30 ], [ "t_region_groundcover_barren", 70 ] ],
      "n": "t_chainfence",
      "o": [ [ "t_chaingate_l", 90 ], [ "t_chainfence_posts", 10 ] ],
      "p": "t_window",
      "q": "t_window_bars",
      "r": "t_window_domestic",
      "s": "t_pavement",
      "t": "t_door_metal_locked",
      "u": "t_gates_control_brick",
      "v": "t_linoleum_gray",
      "Æ": "t_linoleum_gray",
      "w": "t_concrete",
      "x": "t_concrete",
      "y": "t_concrete",
      "z": "t_concrete",
      "A": "t_concrete",
      "B": "t_wall_w",
      "C": [ [ "t_region_shrub_decorative", 80 ], [ "t_region_groundcover", 20 ] ],
      "D": "t_linoleum_white",
      "E": "t_linoleum_white",
      "F": "t_linoleum_white",
      "G": "t_linoleum_white",
      "H": "t_linoleum_gray",
      "I": "t_linoleum_gray",
      "K": "t_concrete",
      "J": "t_concrete",
      "L": "t_concrete",
      "M": "t_concrete",
      "N": "t_concrete",
      "P": "t_metal_dock",
      "Q": [ "t_railroad_rubble", [ "t_region_groundcover_barren", 99 ] ],
      "R": [ "t_railroad_rubble", [ "t_pavement", 99 ] ],
      "S": "t_region_groundcover_barren",
      "T": "t_concrete",
      "U": "t_linoleum_white",
      "V": "t_region_grass",
      "W": "t_concrete",
      "X": [ [ "t_region_groundcover", 20 ], [ "t_region_groundcover_barren", 20 ], [ "t_mud", 60 ] ],
      "Y": "t_brick_oven",
      "Z": "t_gutter_downspout",
      "^": "t_ladder_up"
    },
    "furniture": {
      "i": "f_sign",
      "k": [ [ "f_filing_cabinet", 80 ], [ "f_null", 20 ] ],
      "l": "f_desk",
      "v": "f_table",
      "Æ": "f_table",
      "w": "f_locker",
      "x": "f_counter",
      "y": "f_sink",
      "z": "f_crate_c",
      "A": "f_heavy_duty_freezer",
      "D": "f_chair",
      "E": "f_room_divider",
      "F": [ [ "f_chair", 50 ], [ "f_null", 50 ] ],
      "G": "f_indoor_plant",
      "H": "f_counter",
      "K": "f_toilet",
      "J": "f_table",
      "L": "f_shower",
      "M": "f_counter",
      "N": "f_counter",
      "T": "f_indoor_plant",
      "U": "f_locker",
      "V": "f_standing_tank",
      "W": "f_locker"
    },
    "items": {
      "H": { "item": "hospital_lab", "chance": [ 40, 80 ] },
      "k": { "item": "SUS_office_filing_cabinet", "chance": 70 },
      "l": { "item": "SUS_office_desk", "chance": 30 },
      "v": { "item": "tools_science", "chance": [ 50, 95 ] },
      "w": { "item": "tools_medical", "chance": 30 },
      "x": { "item": "butcher_tools", "chance": [ 5, 20 ], "repeat": [ 1, 3 ] },
      "z": [
        { "item": "butcher_tools", "chance": 75, "repeat": [ 1, 3 ] },
        { "item": "gear_medical", "chance": 50, "repeat": [ 1, 3 ] },
        { "item": "tools_science", "chance": 30, "repeat": [ 1, 3 ] }
      ],
      "N": { "item": "allclothes", "chance": 5, "repeat": [ 3, 8 ] },
      "U": { "item": "office_mess", "chance": [ 50, 70 ], "repeat": [ 1, 3 ] },
      "W": { "item": "butcher_tools", "chance": 20 }
    },
    "signs": {
      "i": {
        "signage": "Welcome to the Everwell test CAFO #37.  Please sign in with the receptionist."
      },
      "B": {
        "signage": "All pig carcasses and parts must be incinerated!  Removal of meat or remains from these premises is grounds for IMMEDIATE termination.",
        "furniture": "f_sign_warning"
      }
    },
    "liquids": { "J": { "liquid": "animal_blood", "chance": [ 20, 40 ] }, "V": { "liquid": "water_clean" } },
    "//": "group_lab_fema used here because it's a suitable group, not to imply a specific FEMA connection",
    "monster": {
      "c": [ { "monster": "mon_zombie_crawler", "chance": 1 } ],
      "e": [ { "monster": "mon_feral_human_knife", "chance": 1 },  { "group": "GROUP_ZOMBIE", "chance": 1 } ],
      "d": [ { "monster": "mon_feral_human_knife", "chance": 1 }, { "group": "GROUP_LAB_FEMA", "chance": 3 } ],
      "b": [ { "monster": "mon_zombie_pig", "chance": 9 }, { "group": "GROUP_PIGS_ZOO", "chance": 1 } ]
    },
    "vehicles": {
      "Q": { "vehicle": "forklift_vehicles", "chance": 40, "rotation": 0 },
      "R": { "vehicle": "suburban_home_compact", "chance": 20, "rotation": [ 0, 180 ] }
    },
    "item": {
      "Æ": { "item": "binder_mutagen_basic", "chance": 80 },
      "H": [ { "item": "purifier", "chance": 8, "amount": [ 1, 2 ] }, { "item": "mutagen", "chance": 8, "amount": [ 1, 2 ] }, { "item": "iv_purifier", "chance": 4 }, { "item": "efile_recipes_science", "chance": 10 } ],
      "b": { "item": "straw_pile", "amount": [ 5, 30 ], "chance": 10 },
      "y": { "item": "soap", "amount": [ 1, 5 ], "chance": 90, "repeat": [ 1, 3 ] },
      "A": [
        { "item": "fat_tainted", "amount": [ 5, 20 ], "chance": [ 35, 80 ], "custom-flags": [ "FROZEN", "E_COLD_START" ] },
        {
          "item": "meat_tainted",
          "amount": [ 5, 20 ],
          "chance": [ 35, 80 ],
          "custom-flags": [ "FROZEN", "E_COLD_START" ]
        },
        {
          "item": "bone_tainted",
          "amount": [ 5, 20 ],
          "chance": [ 35, 80 ],
          "custom-flags": [ "FROZEN", "E_COLD_START" ]
        },
        {
          "item": "mutant_fat",
          "amount": [ 5, 20 ],
          "chance": [ 35, 80 ],
          "custom-flags": [ "FROZEN", "E_COLD_START" ]
        },
        {
          "item": "mutant_meat",
          "amount": [ 5, 20 ],
          "chance": [ 35, 80 ],
          "custom-flags": [ "FROZEN", "E_COLD_START" ]
        },
        {
          "item": "mutant_brain",
          "amount": [ 1, 2 ],
          "chance": [ 25, 45 ],
          "custom-flags": [ "FROZEN", "E_COLD_START" ]
        }
      ],
      "Y": { "item": "ash", "amount": [ 50, 5000 ], "repeat": [ 1, 2 ] }
    }
  },
  {
    "type": "mapgen",
    "om_terrain": [
      [ "pig_farm_lab_ground_NW", "pig_farm_lab_ground_N", "pig_farm_lab_ground_NE" ],
      [ "pig_farm_lab_ground_W", "pig_farm_lab_ground_M", "pig_farm_lab_ground_E" ],
      [ "pig_farm_lab_ground_SW", "pig_farm_lab_ground_S", "pig_farm_lab_ground_SE" ]
    ],
    "object": {
      "fill_ter": "t_region_groundcover",
      "rows": [
        "    ssssssssssssssss                                                    ",
        "    ssssssssssssssss C hhhhhhhhhhhhhhhhhhhhhhhhhhhhhhhhhhhhhhhhhhhhhhhh ",
        "  mmssssssssssssssss   haaaaa^hccccccchccccccchccccccchccccccchccccccch ",
        " mmmssssssssssssssssssshaaaaaahcmmmmmchcmmmmmchcmmmccchcmmmmmchcccmmmch ",
        "   mssssssssssssssssssshaaaaaahmmbbbmmhmmbmmmchmmbmmmmhcmbbbmmhmmmmbmmh ",
        " C mssssssssssssssssssshaaaaaahbmmbmmbhbmmbbmchbmmmmmbhmmmmmmbhmmmmmmmh ",
        "   mssssssssssssssssssshamamaahbmmmmmbhbmmbbmchmbbbbbmhmbbbbbbhbbmmmmbh ",
        "   msssRsssssssssssRssshaaamaahhnooonhhhnooonhhhnooonhhhnooonhhhnooonhh ",
        "   mssssssssssssssssssshaammmaammmmmmmmmmmmmmmmmmmmmmmmmmmmmmmmmmmmmmmh ",
        "   mssssssssssssssssssshaaammaammmmmmmmmmmmmmmmmmmmmmmmmmmmmmmmmmmmmmmh ",
        "   mssssssssssssssssssshamaamahhnooonhhhnooonhhhnooonhhhnooonhhhnooonhh ",
        " C mssssssssssssssssssshaaammahbmmmbbbhcmmmmbbhbbbmmbbhbmmmmbmhmbmmmmbh ",
        "   mssssssssssssssssssshaamaaahbmmmmmbhcmbmmbbhmbbbmbbhmbmmmbmhmbmmmmbh ",
        "   msssRsssssssssssRssshaaammmhbmmccmmhcmmmmbmhcmmmmbmhmmbmmbmhcmbmmbmh ",
        "   mssssssssssssssssssshaamaaahbmmcccmhcmmmmmmhcmmmmmchcmmmmmmhcmmmmmch ",
        "   mssssssssssssssssssshamamaahmmccccchccccccchccccccchccccccchccccccch ",
        "   mssssssssssssssssssshaaaam^hhhhhhhhhhhhhhhhhhhhhhhhhhhhhhhhhhhhhhhhh ",
        " C mssssssssssssssssssshammmaahccccccchccccccchccccccchccccccchccccccch ",
        "  mmssssssssssssssssssshaamaaahcmmmccchcccmmmchcmmmmmchcmmmmmchcmmmmmch ",
        "  mmssRsssssssssssssssshaammaahmmbmmmmhmmmmbmmhmmbbbmmhmmbbbmchcmbbbmmh ",
        "  mmssssssssssssdddddddhaammmahbmmmmmbhbbmmmmbhbmmmbbbhmmmmbmchmmmmmmbh ",
        "  mmssssssssssssdddddddhaaammahmmmmmbmhmmmmmmmhbbmmmbbhbbbbbmchmmmmmmbh ",
        "  CCCCmCCCCmCCCCdddddddiamaamahhnooonhhhnooonhhhnooonhhhnooonhhhnooonhh ",
        "Zjjppjjjppjjjrrrjjpjfjpjaaammaammmmmmmmmmmmmmmmmmmmmmmmmmmmmmmmmmmmmmmh ",
        " jGElllEllljkleeejGeeeGjaamaaaammmmmmmmmmmmmmmmmmmmmmmmmmmmmmmmmmmmmmmh ",
        "CjEFeFeeeFejDleeefeeeeejaaammmhhnooonhhhnooonhhhnooonhhhnooonhhhnooonhh ",
        "CpleeeeeeeejelDeejeeeeejaamaaahmbmmmmbhbmmmbbbhcmmmmbbhbmmmmmmhbbbmmbbh ",
        "CplFeeFeeFFjelDeejeeeeejamamaahmbmmmmbhbbmmmmbhcmbmmmbhmbmmmbmhmbbbmbbh ",
        "Cjleeeeellljeeeeejelllljaaaamahcmbmmbmhbbmccmmhcmbbbbmhmmbmmbmhcmbbbbmh ",
        "CjEeeeeeeGejGUUUGjelDekjammmaahcmmmmmchbmmcccmhcmmmmmmhcmmmmmmhcmmmmmch ",
        "CplFeleeeeejjjjjjjfjjfjjaamaaahccccccchmmccccchccccccchccccccchccccccch ",
        "CplFFleeeeefeeeeeeeeeeeqaamma^hhhhhhhhhhhhhhhhhhhhhhhhhhhhhhhhhhhhhhhhh ",
        "CjleeleeFFefeeeeeeeeeeeqamamaahccccccchccccccchccccccchccccccchccccccch ",
        "CjjjjjffjjjjjjØÐjjjjjeejaaamaahcmmmmmchcmmmmmchcmmmccchcccmmmchcmmmmmch ",
        "CrklkjeejHIIIIIIIIIHjeejaammmahcmbbbmmhmmbbbmchmmbmmmmhmmmmbmmhmmbbbmmh ",
        "CjDlejeejHIIIIIIIIIHjeejaaammahmmmmmmbhmmmmbmchmmmmmbbhbmmmmbbhmmmmmbbh ",
        "CjelefeejHIIvvvÆvIIHjeejamaamahmbmmmmbhbbmbbmchmbbbbbmhbmmmmbbhbbmmmbbh ",
        "CreeejeejHIIvvvvvIIHjeejaaammahhnooonhhhnooonhhhnooonhhhnooonhhhnooonhh ",
        "CjjjjjeejyIIIIIIIIIyjeejaamaaaammmmmmmmmmmmmmmmmmmmmmmmmmmmmmmmmmmmmmmh ",
        "CrklejeejHIIIIIIIIIHjeejaaammmammmmmmmmmmmmmmmmmmmmmmmmmmmmmmmmmmmmmmmh ",
        "CjDlefeejjjjjjjjjjjjjeejaamaaahhnooonhhhnooonhhhnooonhhhnooonhhhnooonhh ",
        "Cjelejeeeeeeeeeeeeeeeeejamamaahbbbmmbbhmmmmmmmhmbmmmmbhmmmbbbbhcmmmmbbh ",
        "Creeejeeeeeeeeeeeeeeeeejaaaamahmmmmmbbhmmmmmmmhmbmmmbbhbbmmmmbhcmmmmmbh ",
        "Cjjjjjfjjddjjjjjjjjjjjjjammmaahcmbbbbmhmmbmmbmhcmmmmbmhbbmccmmhcmmmmmmh ",
        " jwwwwddjddfdNNTrZaamaaaaamaaahcmmmmmchcmmmmmmhcmmmmmchbmmcccmhcmmmmmmh ",
        " qddddddjddjddddjmSaSSmSmamma^hccccccchccccccchccccccchmmccccchccccccch ",
        " qdwwddwjddjyKMLjaSSQSSSSmaamahhhhhhhhhhhhhhhhhhhhhhhhhhhhhhhhhhhhhhhhh ",
        " qdwwddwjddjjjjjjamSSSSmmmmaaaaaaaaaaaaaaaaaaaaaaaaaaaaaaaaaaVVVaaaobbh ",
        " qdddddwjddfdNNTraSSSSSSmmamamaaaaaaaaaaaaaaaaaaaaaaaaaaaaaaaaaaaaanbbh ",
        "ZjwwwwwTjddjddddjaSSQSSSSmmamaaamaaammaaaaaaaaaaaabbaaaaaaaaaaaaaaannnh ",
        " jjjjjjjjddjyKMLjaSSSSSmmmaamaammaaamaaaaaaaaaaaaaaaaaaaaaaaaaaaaaaobbh ",
        " jTWWWWTjddjjjjjjamSQSSSSmamaaamaaaaaamaaaaaaaaaabbbaaaaaaaaaaaaaaanbbh ",
        " jWddddWjddfdNNTraSmSSSmmmmaammaaamammaaaaaaaaaaaaaaammmaaaaaaaaaaannnh ",
        " jWddddWjddjddddjmSSSSSSSmmaammmaaammaaaaaaaaaaaaaammXXXmmmmaaaaaaaobbh ",
        " jWdWWddjddjyKMLjamSSSSSmmaamaaaamaaaaaaaaaaaaaaaaaXXXXXXXXXXmaaaaanbbh ",
        " jjjjjjfjddjjjjjjaammSSmamaaaaamaaamamaaaaaaaaaaaamXXXcccccXXXmmaaannnh ",
        " jxxxxxdjddjAddAjaaaaSSaamaaaaaaamaaammaaaaaaaaaaamXXccccccccXXmmaaobbh ",
        " jydddddjddjAddAjaaaaSSaaaaaaaaaaammamaaaaaaaaaaaamXacccccccccXXmmanbbh ",
        " jxdddddjddjAddAjZaaaSSaaaaaaaaZaaaaaaaaaaaaaaaaaamXXccccccccccXXmannnh ",
        " jxddddddddjzdddjjjjjggjjjjjjjjjhtttttthaaaaaaaaaamXXccccccccccXXmaobbh ",
        " jxddJJddddjzdddzzjdddddxxyxxxdxissssssuaaaaaaaaaamXmcccccccccXXmaanbbh ",
        " jxddJJddddjzdddzzjddddddddddddxhsssssshaaaaaaaaaaamXccccccccXXmaaannnh ",
        " jyddJJddddjzdddzzjddddddddddddxhsssssshaaaaaaaaaaamXXXccccccXXmaaaobbh ",
        " jxddJJddddjjggBjjjddddddJJJJddyhsssssshaaaaaaaaaaamXXXXXXXmXXXaaaanbbh ",
        " jxddJJdddddddddddgddddddJJJJddxhsssssshaaaaaaaaaaaammXXXXmmmmaaaaannnh ",
        " jxddJJdddddddddddgddddddJJJJddxhsssssshaaaaaaaaaabaaammmmaaaaaaaaaobbh ",
        " jxddJJdddddddddddjddddddJJJJddxhsssssshaaaaaaaaaaaaaaaaaaaaaaaaaaanbbh ",
        " jxdddddddddddddddjddddddJJJJddxhsssssshaaahthaaaaaaaaaaaaaaaaaaaaannnh ",
        " jyddddddddddddddxjddddddddddddxhsssssshaaahYhaaaaaaaaaaaaaaaaaaaaaobbh ",
        " jxxxxxyxxxxxyxxxxjdxxyyxxxxxxdxhssssssuaaahhhaaaaaaaaaaaaaaaaaaaaanbbh ",
        " jjjjjjjjjjjjjjjjjjjjjjjjjjjjjjjhtttttthhhhhhhhhhhhhhhhhhhhhhhhhhhhhhhh ",
        " Z                             Z                                        "
      ],
      "flags": [ "ERASE_ALL_BEFORE_PLACING_TERRAIN" ],
      "palettes": [ "farm_lab_palette_01" ],
      "place_monster": [ { "monster": "mon_turret_rifle", "spawn_data": { "ammo": [ { "ammo_id": "556", "qty": [ 30, 90 ] } ] }, "x": 15, "y": 39, "chance": 100 } ]
    }
  },
  {
    "type": "mapgen",
    "om_terrain": [
      [ "pig_farm_lab_roof_NW", "pig_farm_lab_roof_N", "pig_farm_lab_roof_NE" ],
      [ "pig_farm_lab_roof_W", "pig_farm_lab_roof_M", "pig_farm_lab_roof_E" ],
      [ "pig_farm_lab_roof_SW", "pig_farm_lab_roof_S", "pig_farm_lab_roof_SE" ]
    ],
    "object": {
      "fill_ter": "t_flat_roof",
      "terrain": {
        "_": "t_metal_floor_no_roof",
        "I": "t_metal_railing",
        "=": "t_concrete_roof"
      },
      "furniture": {
        "=": "f_null"
      },
      "rows": [
        "                                                                        ",
        "                       =======IIIIIIIIIIIIIIIIIIIIIIIIIIIIIIIIIIIIIIIII ",
        "                       =     v________________________________________I ",
        "                       =      IIIIIIIIIIIIIIIIIIIIIIIIIIIIIIIIIIIIIIIII ",
        "                       =      =       =       =       =       =       = ",
        "                       =      =       =       =       =       =       = ",
        "                       =      =       =       =       =       =       = ",
        "                       =      ==     ===     ===     ===     ===     == ",
        "                       =                                                ",
        "                       =                                                ",
        "                       =      ==     ===     ===     ===     ===     == ",
        "                       =      =       =       =       =       =       = ",
        "                       =      =       =       =       =       =       = ",
        "                       =      =       =       =       =       =       = ",
        "                       =      IIIIIIIIIIIIIIIIIIIIIIIIIIIIIIIIIIIIIIIII ",
        "                       =      I_______________________________________I ",
        "                       =     v________________________________________I ",
        "                       =      I_______________________________________I ",
        "                       =      IIIIIIIIIIIIIIIIIIIIIIIIIIIIIIIIIIIIIIIII ",
        "                       =      =       =       =       =       =       = ",
        "                -------=      =       =       =       =       =       = ",
        "                -.....-=      =       =       =       =       =       = ",
        "                -.....-=      ==     ===     ===     ===     ===     == ",
        " 5---------------------5                                                ",
        " -.....................-                                                ",
        " -.....................-      ==     ===     ===     ===     ===     == ",
        " -..:..................-      =       =       =       =       =       = ",
        " -...........X.........-      =       =       =       =       =       = ",
        " -.....................-      =       =       =       =       =       = ",
        " -.....................-      IIIIIIIIIIIIIIIIIIIIIIIIIIIIIIIIIIIIIIIII ",
        " -.....................-      I_______________________________________I ",
        " -.....................-     v________________________________________I ",
        " -.....................-      I_______________________________________I ",
        " -.....................-      IIIIIIIIIIIIIIIIIIIIIIIIIIIIIIIIIIIIIIIII ",
        " -........&.......&....-      =       =       =       =       =       = ",
        " -.....................-      =       =       =       =       =       = ",
        " -.....................-      =       =       =       =       =       = ",
        " -.....................-      ==     ===     ===     ===     ===     == ",
        " -.....................-                                              = ",
        " -........&.......&....-                                              = ",
        " -.....................-      ==     ===     ===     ===     ===     == ",
        " -.....................-      =       =       =       =       =       = ",
        " -.....................-      =       =       =       =       =       = ",
        " -..............5-------      =       =       =       =       =       = ",
        " -..............-             IIIIIIIIIIIIIIIIIIIIIIIIIIIIIIIIIIIIIIIII ",
        " -..............-            v________________________________________I ",
        " -..............-             IIIIIIIIIIIIIIIIIIIIIIIIIIIIIIIIIIIIIII_I ",
        " -..............-                                                   I_I ",
        " 5..............-                                                   I_I ",
        " -..............-                                                   I_I ",
        " -..............-                                                   I_I ",
        " -..............-                                                   I_I ",
        " -..............-                                                   I_I ",
        " -..............-                                                   I_I ",
        " -..............-                                                   I_I ",
        " -..............-                                                   I_I ",
        " -..............-                                                   I_I ",
        " -..............-                                                   I_I ",
        " -..............-                                                   I_I ",
        " -..............5--------------5                                    I_I ",
        " -...&.........................-                                    I_I ",
        " -.............................-                                    I_I ",
        " -.............................-                                    I_I ",
        " -.........................&...-                                    I_I ",
        " -.............................-                                    I_I ",
        " -.............................-                                    I_I ",
        " -.............................-                                    I_I ",
        " -...&.....................&...-           ===                      I_I ",
        " -.............................-           =~=                      I_I ",
        " -.............................-           ===                      III ",
        " 5-----------------------------5======================================= ",
        "                                                                        "
      ],
      "palettes": [ "roof_palette" ],
      "monster": {
        "-": [ { "group": "GROUP_ROOF_ANIMAL", "chance": 1 } ]
      }
    }
  }
]
