[
  {
    "type": "palette",
    "id": "farm_lab_palette_01",
    "terrain": {
      "a": "t_region_groundcover",
      "b": "t_region_grass",
      "c": [ [ "t_mud", 90 ], [ "t_water_murky", 10 ] ],
      "d": "t_concrete",
      "e": "t_linoleum_white",
      "f": "t_door_c",
      "g": [ [ "t_door_b", 30 ], [ "t_door_c", 70 ] ],
      "h": "t_brick_wall",
      "i": "t_brick_wall",
      "j": "t_wall_w",
      "k": "t_linoleum_white",
      "l": "t_linoleum_white",
      "m": [ [ "t_region_groundcover", 60 ], [ "t_region_groundcover_barren", 40 ] ],
      "n": "t_chainfence",
      "o": [ [ "t_chaingate_l", 90 ], [ "t_chainfence_posts", 10 ] ],
      "p": "t_window",
      "q": "t_window_bars",
      "r": "t_window_domestic",
      "s": "t_pavement",
      "t": "t_door_metal_locked",
      "u": "t_gates_control_brick",
      "v": "t_linoleum_gray",
      "w": "t_concrete",
      "x": "t_concrete",
      "y": "t_concrete",
      "z": "t_concrete",
      "A": "t_concrete",
      "B": "t_wall_w",
      "C": [ [ "t_region_shrub_decorative", 80 ], [ "t_region_groundcover", 20 ] ],
      "D": "t_linoleum_white",
      "E": "t_linoleum_white",
      "F": "t_linoleum_white",
      "G": "t_linoleum_white",
      "H": "t_linoleum_gray",
      "I": "t_linoleum_gray",
      "K": "t_concrete",
      "J": "t_concrete",
      "L": "t_concrete",
      "M": "t_concrete",
      "N": "t_concrete",
      "P": "t_metal_dock",
      "Q": [ "t_railroad_rubble", [ "t_region_groundcover_barren", 99 ] ],
      "R": [ "t_railroad_rubble", [ "t_pavement", 99 ] ],
      "S": "t_region_groundcover_barren",
      "T": "t_concrete",
      "U": "t_linoleum_white",
      "V": "t_region_grass",
      "W": "t_concrete",
      "X": [ [ "t_region_groundcover", 30 ], [ "t_region_groundcover_barren", 10 ], [ "t_mud", 60 ] ],
      "Y": "t_brick_oven",
      "Z": "t_gutter_downspout"
    },
    "furniture": {
      "i": "f_sign",
      "k": [ [ "f_filing_cabinet", 80 ], [ "f_null", 20 ] ],
      "l": "f_desk",
      "v": "f_table",
      "w": "f_locker",
      "x": "f_counter",
      "y": "f_sink",
      "z": "f_crate_c",
      "A": "f_freezer",
      "D": "f_chair",
      "E": "f_room_divider",
      "F": [ [ "f_chair", 50 ], [ "f_null", 50 ] ],
      "G": "f_indoor_plant",
      "H": "f_desk",
      "K": "f_toilet",
      "J": "f_table",
      "L": "f_shower",
      "M": "f_counter",
      "N": "f_counter",
      "T": "f_indoor_plant",
      "U": "f_locker",
      "V": "f_standing_tank",
      "W": "f_locker"
    },
    "items": {
      "k": { "item": "SUS_office_filing_cabinet", "chance": 70 },
      "l": { "item": "SUS_office_desk", "chance": 30 },
      "v": { "item": "tools_science", "chance": [ 50, 95 ] },
      "w": { "item": "tools_medical", "chance": 20 },
      "x": { "item": "butcher_tools", "chance": [ 5, 20 ], "repeat": [ 1, 3 ] },
      "z": [
        { "item": "butcher_tools", "chance": 75, "repeat": [ 1, 3 ] },
        { "item": "gear_medical", "chance": 50, "repeat": [ 1, 3 ] },
        { "item": "tools_science", "chance": 25, "repeat": [ 1, 3 ] }
      ],
      "H": { "item": "hospital_lab", "chance": [ 60, 90 ] },
      "N": { "item": "allclothes", "chance": 5, "repeat": [ 3, 8 ] },
      "U": { "item": "SUS_office_mess", "chance": [ 50, 70 ], "repeat": [ 1, 3 ] },
      "W": { "item": "butcher_tools", "chance": 20 }
    },
    "signs": {
      "i": {
        "signage": "Welcome to Monsanto Philip Morris porcine agrogenetics of <city> . Please sign in with the receptionist."
      },
      "B": {
        "signage": "All pig corpses and parts must be incinerated, any employees caught stealing or eating the meat shall be fired immetiatly.",
        "furniture": "f_sign_warning"
      }
    },
    "liquids": { "J": { "liquid": "animal_blood", "chance": [ 20, 40 ] }, "V": { "liquid": "water_clean" } },
    "monster": {
      "b": [ { "monster": "mon_pig", "chance": 5 }, { "monster": "mon_zombie_pig", "chance": 2 } ],
      "P": { "group": "GROUP_PIGS_ZOO", "use_pack_size": true, "pack_size": 10, "name": "Zorlib the Megahog" }
    },
    "vehicles": {
      "Q": { "vehicle": "forklift_vehicles", "chance": 60, "rotation": 0 },
      "R": { "vehicle": "suburban_home_compact", "chance": 20, "rotation": [ 0, 180 ] }
    },
    "item": {
      "b": { "item": "straw_pile", "amount": [ 5, 30 ], "chance": 10 },
      "y": { "item": "soap", "amount": [ 1, 5 ], "chance": 90, "repeat": [ 1, 3 ] },
      "A": [
        { "item": "fat_tainted", "amount": [ 5, 20 ], "chance": [ 35, 80 ], "custom-flags": [ "FROZEN", "E_COLD_START" ] },
        {
          "item": "meat_tainted",
          "amount": [ 5, 20 ],
          "chance": [ 35, 80 ],
          "custom-flags": [ "FROZEN", "E_COLD_START" ]
        },
        {
          "item": "bone_tainted",
          "amount": [ 5, 20 ],
          "chance": [ 35, 80 ],
          "custom-flags": [ "FROZEN", "E_COLD_START" ]
        },
        {
          "item": "mutant_fat",
          "amount": [ 5, 20 ],
          "chance": [ 35, 80 ],
          "custom-flags": [ "FROZEN", "E_COLD_START" ]
        },
        {
          "item": "mutant_meat",
          "amount": [ 5, 20 ],
          "chance": [ 35, 80 ],
          "custom-flags": [ "FROZEN", "E_COLD_START" ]
        },
        {
          "item": "mutant_brain",
          "amount": [ 1, 2 ],
          "chance": [ 25, 45 ],
          "custom-flags": [ "FROZEN", "E_COLD_START" ]
        }
      ],
      "Y": { "item": "ash", "amount": [ 50, 5000 ], "repeat": [ 1, 2 ] }
    }
  },
  {
    "type": "mapgen",
    "om_terrain": [
      [ "pig_farm_lab_ground_NW", "pig_farm_lab_ground_N", "pig_farm_lab_ground_NE" ],
      [ "pig_farm_lab_ground_W", "pig_farm_lab_ground_M", "pig_farm_lab_ground_E" ],
      [ "pig_farm_lab_ground_SW", "pig_farm_lab_ground_S", "pig_farm_lab_ground_SE" ]
    ],
    "object": {
      "fill_ter": "t_region_groundcover",
      "rows": [
        "    ssssssssssssssss                                                    ",
        "    ssssssssssssssss C hhhhhhhhhhhhhhhhhhhhhhhhhhhhhhhhhhhhhhhhhhhhhhhh ",
        "  mmssssssssssssssss   haaaaaahccccccchccccccchccccccchccccccchccccccch ",
        " mmmssssssssssssssssssshaaaaaahcmmmmmchcmmmmmchcmmmccchcmmmmmchcccmmmch ",
        "   mssssssssssssssssssshaaaaaahmmbbbmmhmmbbbmchmmbmmmmhcmbbbmmhmmmmbmmh ",
        " C mssssssssssssssssssshaaaaaahbbbbbbbhbbbbbmchbbbbbbbhmmbbbbbhbbbbbbbh ",
        "   mssssssssssssssssssshamamaahbbmmmbbhbbbbbmchmbbbbbmhmbbbbbbhbbbbbbbh ",
        "   msssRsssssssssssRssshaaamaahhnooonhhhnooonhhhnooonhhhnooonhhhnooonhh ",
        "   mssssssssssssssssssshaammmaammmmmmmmmmmmmmmmmmmmmmmmmmmmmmmmmmmmmmmh ",
        "   mssssssssssssssssssshaaammaammmmmmmmmmmmmmmmmmmmmmmmmmmmmmmmmmmmmmmh ",
        "   mssssssssssssssssssshamaamahhnooonhhhnooonhhhnooonhhhnooonhhhnooonhh ",
        " C mssssssssssssssssssshaaammahbbbbbbbhcmmmmbbhbbbmmbbhbbbbbbmhmbbbbbbh ",
        "   mssssssssssssssssssshaamaaahbbmmmmbhcmbbbbbhmbbbmbbhmbbbbbmhmbbbbbbh ",
        "   msssRsssssssssssRssshaaammmhbbmccmmhcmbbbbmhcmbbbbmhmmbbbbmhcmbbbbmh ",
        "   mssssssssssssssssssshaamaaahbmmcccmhcmmmmmmhcmmmmmchcmmmmmmhcmmmmmch ",
        "   mssssssssssssssssssshamamaahmmccccchccccccchccccccchccccccchccccccch ",
        "   mssssssssssssssssssshaaaamahhhhhhhhhhhhhhhhhhhhhhhhhhhhhhhhhhhhhhhhh ",
        " C mssssssssssssssssssshammmaahccccccchccccccchccccccchccccccchccccccch ",
        "  mmssssssssssssssssssshaamaaahcmmmccchcccmmmchcmmmmmchcmmmmmchcmmmmmch ",
        "  mmssRsssssssssssssssshaammaahmmbmmmmhmmmmbmmhmmbbbmmhmmbbbmchcmbbbmmh ",
        "  mmssssssssssssdddddddhaammmahbbbbbbbhbbbbbbbhbbbbbbbhbbbbbmchmmbbbbbh ",
        "  mmssssssssssssdddddddhaaammahmbbbbbmhbbbbbbbhbbmmmbbhbbbbbmchmbbbbbbh ",
        "  CCCCmCCCCmCCCCdddddddiamaamahhnooonhhhnooonhhhnooonhhhnooonhhhnooonhh ",
        "Zjjppjjjppjjjrrrjjpjfjpjaaammaammmmmmmmmmmmmmmmmmmmmmmmmmmmmmmmmmmmmmmh ",
        " jGElllEllljkleeejGeeeGjaamaaaammmmmmmmmmmmmmmmmmmmmmmmmmmmmmmmmmmmmmmh ",
        "CjEFeFeeeFejDleeefeeeeejaaammmhhnooonhhhnooonhhhnooonhhhnooonhhhnooonhh ",
        "CpleeeeeeeejelDeejeeeeejaamaaahmbbbbbbhbbbbbbbhcmmmmbbhbbbbbbmhbbbmmbbh ",
        "CplFeeFeeFFjelDeejeeeeejamamaahmbbbbbbhbbmmmmbhcmbbbbbhmbbbbbmhmbbbmbbh ",
        "Cjleeeeellljeeeeejelllljaaaamahcmbbbbmhbbmccmmhcmbbbbmhmmbbbbmhcmbbbbmh ",
        "CjEeeeeeeGejGUUUGjelDekjammmaahcmmmmmchbmmcccmhcmmmmmmhcmmmmmmhcmmmmmch ",
        "CplFeleeeeejjjjjjjfjjfjjaamaaahccccccchmmccccchccccccchccccccchccccccch ",
        "CplFFleeeeefeeeeeeeeeeejaammaahhhhhhhhhhhhhhhhhhhhhhhhhhhhhhhhhhhhhhhhh ",
        "CjleeleeFFefeeeeeeeeeeejamamaahccccccchccccccchccccccchccccccchccccccch ",
        "Cjjjjjffjjjjjjggjjjjjeejaaamaahcmmmmmchcmmmmmchcmmmccchcccmmmchcmmmmmch ",
        "CrklkjeejHIIIIIIIIIHjeejaammmahcmbbbmmhmmbbbmchmmbmmmmhmmmmbmmhmmbbbmmh ",
        "CjDlejeejHIIIIIIIIIHjeejaaammahmmbbbbbhbbbbbmchbbbbbbbhbbbbbbbhbbbbbbbh ",
        "CjelefeejHIIvvvvvIIHjeejamaamahmbbbbbbhbbbbbmchmbbbbbmhbbbbbbbhbbmmmbbh ",
        "CreeejeejHIIvvvvvIIHjeejaaammahhnooonhhhnooonhhhnooonhhhnooonhhhnooonhh ",
        "CjjjjjeejHIIIIIIIIIHjeejaamaaaammmmmmmmmmmmmmmmmmmmmmmmmmmmmmmmmmmmmmmh ",
        "CrklejeejHIIIIIIIIIHjeejaaammmammmmmmmmmmmmmmmmmmmmmmmmmmmmmmmmmmmmmmmh ",
        "CjDlefeejjjjjjjjjjjjjeejaamaaahhnooonhhhnooonhhhnooonhhhnooonhhhnooonhh ",
        "Cjelejeeeeeeeeeeeeeeeeejamamaahbbbmmbbhbbbbbbmhmbbbbbbhbbbbbbbhcmmmmbbh ",
        "Creeejeeeeeeeeeeeeeeeeejaaaamahmbbbmbbhmbbbbbmhmbbbbbbhbbmmmmbhcmbbbbbh ",
        "Cjjjjjfjjddjjjjjjjjjjjjjammmaahcmbbbbmhmmbbbbmhcmbbbbmhbbmccmmhcmbbbbmh ",
        " jwwwwddjddfdNNTrZaamaaaaamaaahcmmmmmchcmmmmmmhcmmmmmchbmmcccmhcmmmmmmh ",
        " qddddddjddjddddjmSaSSmSmammaahccccccchccccccchccccccchmmccccchccccccch ",
        " qdwwddwjddjyKMLjaSSQSSSSmaamahhhhhhhhhhhhhhhhhhhhhhhhhhhhhhhhhhhhhhhhh ",
        " qdwwddwjddjjjjjjamSSSSmmmmaaaaaaaaaaaaaaaaaaaaaaaaaaaaaaaaaaVVVaaaobbh ",
        " qdddddwjddfdNNTraSSSSSSmmamamaaaaaaaaaaaaaaaaaaaaaaaaaaaaaaaaaaaaanbbh ",
        "ZjwwwwwTjddjddddjaSSQSSSSmmamaaamaaammaaaaaaaaaaaaaaaaaaaaaaaaaaaaannnh ",
        " jjjjjjjjddjyKMLjaSSSSSmmmaamaammaaamaaaaaaaaaaaaaaaaaaaaaaaaaaaaaaobbh ",
        " jTWWWWTjddjjjjjjamSQSSSSmamaaamaaaaaamaaaaaaaaaaaaaaaaaaaaaaaaaaaanbbh ",
        " jWddddWjddfdNNTraSmSSSmmmmaammaaamammaaaaaaaaaaaaaaammmaaaaaaaaaaannnh ",
        " jWddddWjddjddddjmSSSSSSSmmaammmaaammaaaaaaaaaaaaaammXXXmmmmaaaaaaaobbh ",
        " jWdWWddjddjyKMLjamSSSSSmmaamaaaamaaaaaaaaaaaaaaaaaXXXXXXXXXXmaaaaanbbh ",
        " jjjjjjfjddjjjjjjaammSSmamaaaaamaaamamaaaaaaaaaaaamXXXcccccXXXmmaaannnh ",
        " jxxxxxdjddjAddAjaaaaSSaamaaaaaaamaaammaaaaaaaaaaamXXccccccccXXmmaaobbh ",
        " jydddddjddjAddAjaaaaSSaaaaaaaaaaammamaaaaaaaaaaaamXacccccccccXXmmanbbh ",
        " jxdddddjddjAddAjZaaaSSaaaaaaaaZaaaaaaaaaaaaaaaaaamXXccccccccccXXmannnh ",
        " jxddddddddjAddAjjjjjggjjjjjjjjjhtttttthaaaaaaaaaamXXccccccccccXXmaobbh ",
        " jxddJJddddjzdddzzjdddddxxyxxxdxissssssuaaaaaaaaaamXmcccccccccXXmaanbbh ",
        " jxddJJddddjzdddzzjddddddddddddxhsssssshaaaaaaaaaaamXccccccccXXmaaannnh ",
        " jyddJJddddjzdddzzjddddddddddddxhsssssshaaaaaaaaaaamXXXccccccXXmaaaobbh ",
        " jxddJJddddjjggBjjjddddddJJJJddyhsssssshaaaaaaaaaaamXXXXXXXmXXXaaaanbbh ",
        " jxddJJdddddddddddgddddddJJJJddxhsssssshaaaaaaaaaaaammXXXXmmmmaaaaannnh ",
        " jxddJJdddddddddddgddddddJJJJddxhsssssshaaaaaaaaaaaaaammmmaaaaaaaaaobbh ",
        " jxddJJdddddddddddjddddddJJJJddxhsssssshaaaaaaaaaaaaaaaaaaaaaaaaaaanbbh ",
        " jxdddddddddddddddjddddddJJJJddxhsssssshaaahthaaaaaaaaaaaaaaaaaaaaannnh ",
        " jyddddddddddddddxjddddddddddddxhsssssshaaahYhaaaaaaaaaaaaaaaaaaaaaobbh ",
        " jxxxxxyxxxxxyxxxxjdxxyyxxxxxxdxhssssssuaaahhhaaaaaaaaaaaaaaaaaaaaanbbh ",
        " jjjjjjjjjjjjjjjjjjjjjjjjjjjjjjjhtttttthhhhhhhhhhhhhhhhhhhhhhhhhhhhhhhh ",
        " Z                             Z                                        "
      ],
      "flags": [ "ERASE_ALL_BEFORE_PLACING_TERRAIN" ],
      "palettes": [ "farm_lab_palette_01" ]
    }
  },
  {
    "type": "mapgen",
    "om_terrain": [
      [ "pig_farm_lab_roof_NW", "pig_farm_lab_roof_N", "pig_farm_lab_roof_NE" ],
      [ "pig_farm_lab_roof_W", "pig_farm_lab_roof_M", "pig_farm_lab_roof_E" ],
      [ "pig_farm_lab_roof_SW", "pig_farm_lab_roof_S", "pig_farm_lab_roof_SE" ]
    ],
    "object": {
      "fill_ter": "t_flat_roof",
      "rows": [
        "                                                                        ",
        "                              5________________________________________ ",
        "                              _________________________________________ ",
        "                              _________________________________________ ",
        "                                                                        ",
        "                                                                        ",
        "                                                                        ",
        "                                                                        ",
        "                                                                        ",
        "                                                                        ",
        "                                                                        ",
        "                                                                        ",
        "                                                                        ",
        "                                                                        ",
        "                              _________________________________________ ",
        "                              _________________________________________ ",
        "                              5________________________________________ ",
        "                              _________________________________________ ",
        "                              _________________________________________ ",
        "                                                                        ",
        "                -------                                                 ",
        "                -.....-                                                 ",
        "                -.....-                                                 ",
        " 5---------------------5                                                ",
        " -.....................-                                                ",
        " -.....................-                                                ",
        " -..:..................-                                                ",
        " -...........X.........-                                                ",
        " -.....................-                                                ",
        " -.....................-      _________________________________________ ",
        " -.....................-      _________________________________________ ",
        " -.....................-      5________________________________________ ",
        " -.....................-      _________________________________________ ",
        " -.....................-      _________________________________________ ",
        " -........&.......&....-                                                ",
        " -.....................-                                                ",
        " -.....................-                                                ",
        " -.....................-                                                ",
        " -.....................-                                                ",
        " -........&.......&....-                                                ",
        " -.....................-                                                ",
        " -.....................-                                                ",
        " -.....................-                                                ",
        " -..............5-------                                                ",
        " -..............-             _________________________________________ ",
        " -..............-             _________________________________________ ",
        " -..=...........-             5________________________________________ ",
        " -..............-                                                   ___ ",
        " 5..............-                                                   ___ ",
        " -..............-                                                   ___ ",
        " -..............-                                                   ___ ",
        " -..............-                                                   ___ ",
        " -..=...........-                                                   ___ ",
        " -..............-                                                   ___ ",
        " -..............-                                                   ___ ",
        " -..............-                                                   ___ ",
        " -..............-                                                   ___ ",
        " -..............-                                                   ___ ",
        " -..............-                                                   ___ ",
        " -..............5--------------5                                    ___ ",
        " -...&.........................-                                    ___ ",
        " -.............................-                                    ___ ",
        " -.............................-                                    ___ ",
        " -.........................&...-                                    ___ ",
        " -.............................-                                    ___ ",
        " -.............................-                                    ___ ",
        " -.............................-                                    ___ ",
        " -...&.....................&...-           ...                      ___ ",
        " -.............................-           .~.                      ___ ",
        " -.............................-           ...                      ___ ",
        " 5-----------------------------5                                    ___ ",
        "                                                                        "
      ],
      "palettes": [ "roof_palette" ]
    }
  }
]
