[
  {
    "type": "mapgen",
    "om_terrain": [ [ "sugar_house_parking" ], [ "sugar_house" ] ],
    "object": {
      "fill_ter": { "param": "linoleum_color", "fallback": "t_linoleum_white" },
      "rows": [
        "!                       ",
        "                        ",
        "                        ",
        "                        ",
        "                        ",
        "                        ",
        "                        ",
        "                        ",
        "                        ",
        "                        ",
        "                        ",
        "                        ",
        "                        ",
        "                        ",
        "                        ",
        "                        ",
        "                        ",
        "                        ",
        "                        ",
        "                        ",
        "                        ",
        "                        ",
        "                        ",
        "                        ",
        "¶                       ",
        "                        ",
        "                        ",
        "                        ",
        "                        ",
        "                        ",
        "                        ",
        "                        ",
        "                        ",
        "                        ",
        "                        ",
        "                        ",
        "                        ",
        "                        ",
        "                        ",
        "                        ",
        "                        ",
        "                        ",
        "                        ",
        "                        ",
        "                        ",
        "                        ",
        "                        ",
        "                        "
      ],
      "palettes": [ "parametrized_linoleum_palette" ],
      "nested": {
        "!": { "chunks": [ [ "sugar_house_parking_lot", 100 ] ] },
        "¶": { "chunks": [ [ "sugar_house_rat", 33 ], [ "sugar_house_normal", 34 ], [ "sugar_house_roach", 33 ] ] }
      }
    }
  },
  {
    "type": "mapgen",
    "om_terrain": "sugar_house_roof",
    "object": {
      "fill_ter": "t_shingle_flat_roof",
      "rows": [
        "                        ",
        " ---------------------  ",
        " -...................-  ",
        " -...................-  ",
        " -...................-  ",
        " -...................-  ",
        " -.......%...........5--",
        " -.......%.............-",
        " -.....................-",
        " -.....................-",
        " -.....................-",
        " -.....................-",
        " -.............N......=-",
        " -.....................-",
        " -...................---",
        " -...&...............-  ",
        " -.............&.....-  ",
        " -...................-  ",
        " -...................-  ",
        " -...................-  ",
        " -...................-  ",
        " -...................-  ",
        " 5--------------------  ",
        "                        "
      ],
      "palettes": [ "roof_palette" ],
      "furniture": { "%": "f_chimney", "N": "f_TV_antenna" },
      "terrain": { ".": "t_shingle_flat_roof" },
      "place_monster": [ { "group": "GROUP_ROOF_ANIMAL", "x": [ 4, 11 ], "y": [ 7, 15 ], "repeat": [ 1, 3 ], "chance": 25 } ]
    }
  }
]
