[
  {
    "type": "mapgen",
    "method": "json",
    "om_terrain": [
      [ "steel_mill_slag_0_1", "steel_mill_slag_0_2", "steel_mill_slag_0_3", "steel_mill_slag_0_4" ],
      [ "steel_mill_slag_1_1", "steel_mill_slag_1_2", "steel_mill_slag_1_3", "steel_mill_slag_1_4" ],
      [ "steel_mill_slag_2_1", "steel_mill_slag_2_2", "steel_mill_slag_2_3", "steel_mill_slag_2_4" ],
      [ "steel_mill_slag_3_1", "steel_mill_slag_3_2", "steel_mill_slag_3_3", "steel_mill_slag_rail_1" ],
      [ "steel_mill_slag_4_1", "steel_mill_slag_4_2", "steel_mill_slag_4_3", "steel_mill_slag_rail_2" ]
    ],
    "object": {
      "fill_ter": "t_thconc_floor_no_roof",
      "rows": [
        "vvvvvvvvvvvvvvvvvvvvvvvvvvvvvvvvvvvvvvvvvvvvvvvvvvv._______,,_______.vvvvvvvvvvvvvvvvvvvvvvvvvvv",
        "v..................................................._______,,_______...........................v",
        "v..................................................___________________________________,,,,,,,,.v",
        "v....]]]]]]]]]]]]**]]]**]]**]]**].................____________________________________________.v",
        "v....]ee]ee]<< #ch  #ch  #Sch  S]-------------..._____________________________________________.v",
        "v....]ee@ee]<< #ddd #ddd #Sddd 7]--------------.______________________________________________.v",
        "v....]xx]xx]   # h  # h  #  h  7]]]++]++]]]----_______________________________________________.v",
        "v....]         #   S#   S#77   T]h        ]----_______________________________________,,,,,,,,.v",
        "v....*         #+####+#######+##]h        ]----_______________,,,,,,,,,,,,,,,,,_______________.v",
        "v....*                   +      ]h  qqqqcq]----_______________________,_______________________.v",
        "v....]hTh DV             +      +   q  h  *----_______________________,_______________________.v",
        "v....]######   ###########      +         *----_______________________,_______________________.v",
        "v....]l l l#   #q0q0q0q0q#      ]     7777]----_______________________,_______________,,,,,,,,.v",
        "v....]l l l#   +         #     h]]]]]]]]]]]----_______________,,,,,,,,,,,,,,,,,_______________.v",
        "v....]l l l#   #+#+#+#+#+#     h]--------------_______________________,_______________________.v",
        "v....]l    +   #t#t#t#t#t#     h]--------------_______________________,_______________________.v",
        "v....]l   l#   ###########      *--___________________________________,_______________________.v",
        "v....]l   l#             +      *--___________________________________,_______________,,,,,,,,.v",
        "v....]]]]]]]D            +      ]--___________________________,,,,,,,,,,,,,,,,,_______________.v",
        "v..........]]]]**]]]]**]]]++#++]]--___________________________________,_______________________.v",
        "v........................]     ].--,,,,,,,,___________________________,_______________________.v",
        "v........................*     *.--___________________________________,_______________________.v",
        "v....]]]]]]]]]]]]]]].....*     *.--___________________________________,_______________,,,,,,,,.v",
        "v....]MMMMLL96666661.....]     ].--___________________________,,,,,,,,,,,,,,,,,_______________.v",
        "v....]FFFFELL966666]]]]]]]++#++]]--___________________________________,_______________________.v",
        "v....]F  x|LLL96666]lllll]      ]--------------_______________________,_______________________.v",
        "v....]F  x|LLL96666R     +      ]]]]]]]]]]]]]]]_______________________,_______________________.v",
        "v....]FFFF LLL96666]+]]]]]]]]]++#CCCCCCCCCCCCC]_______________________,_______________,,,,,,,,.v",
        "v....]MMMM LLL96666666ss66ss6]  #  C  C  C   C]____________.)))))))))),,,,,,,,,_______________.v",
        "v....]FFFF LLL96666666ss66ss6]  #  C  C  C   C]____________.) b  bbb ),_______________________.v",
        "v....]F  x|LLL96666666ss66ss6]  #  C  C  C   C]____________-+       b),_______________________.v",
        "v....]F  x|LLL96666666ss66ss6]  +            C]____________.) bbb  bb),_______________________.v",
        "v....]FFFF LLL966666666666666+  ##############]____________.)b  b  bb),_______________,,,,,,,,.v",
        "v....]MMMM LLL966666666966666+  #CCCCCC#sssss]]____________.)))))))))),,,,,,,,,_______________.v",
        "v....]FFFF LLL966666669996666]  #C     #s s s]]____________..........v,_______________________.v",
        "v....]F  x|LLL966666669999999]  #      #s   ]] ____________..........v,_______________________.v",
        "v....]F  x|LLL96666666669999<]  +      +   ]] `____________..........v,_______________________.v",
        "v....]FFFFELLL96666666666999<]  #      #ss]]   ____________..........v,_______________,,,,,,,,.v",
        "v....]P  P LLL96666666666999@]++]]]]]]]]]]] b `____________..........v,,,,,,,,,_______________.v",
        "v....]P  P 999999996666669999]   hTh hTh f]b   ____________''''''''''vvvvvvvvvvvvvvvvvvvvvvvvvvv",
        "v....]MMMMPPPPPPPMET666999966]           n]  b`____________''OOOOOOO'''''''''''''''''''''''''''v",
        "v....]MEEMPPPPPPPEMT666996666]    DV  n0nn]    ____________''xoooooO'''''''''''''OOOOOOO'''''''v",
        "v....]mccm44<<44mPP9999966666]++]]]]]]]]]]]   `____________''xoooooO'''''''''''''xoooooO'''''''v",
        "v....]44444444444PP9999666666]           ;]    ____________''OOOOOOO'''''''''''''xoooooO'''''''v",
        "v....]#####44444<PP<966666666x            x   `____________''''''''''''''''''''''OOOOOOO'''''''v",
        "v....]<<A R44444<PP<966699666x            x    ____________''OOOOOOO'''OOOOOOO'''''''''''''''''v",
        "v....]    R444444PP9966999966x            x   `____________''xoooooO'''xoooooO'''''''''''''''''v",
        "v....]l   #44444mPPm966699966x            x  b ____________''xoooooO'''xoooooO'''''''''''''''''v",
        "v....]l   +4444/EMME966669966x            x   `____________''OOOOOOO'''OOOOOOO'''''''''''''''''v",
        "v....]#####44444EMME966666666];           ]    ____________''''''''''''''''''''''''''''''''''''v",
        "v....]4444444444m||m966699666]]]]+]xxxxx]]]b  `______________________________________________,'v",
        "v...-]]4444444444||9966699666666]       ; ]    ______________________________________________,'v",
        "v...--+444444444m||m966699666666+ 111111  +   `______________________________________________,'v",
        "v...-]]444444444EppE966699966666+ 111111  +    ______________________________________________,'v",
        "v...-]4444444444EppE966666999666]   m  m  ]   `______________________________________________,'v",
        "v....]4444444444m||m966666699666]Mm||||   ]]   ______________________________________________,'v",
        "v....]44444444444||9966669999666]Mm||||    ]] `______________________________________________,'v",
        "v....]444444444mm||mm66699999666]P  mMMm    ]] ______________________________________________,'v",
        "v....]333333344/MMME996666666666]P   ||  11  ]]______________________________________________,'v",
        "v....]3333333333EMMMPP9666666PPPPP   ||  111  ]______________________________________________,'v",
        "v....]3333mmm333MMMM996666666666]8  mppm 1111 ]______________________________________________,'v",
        "v....]3333EM|||||||6666666666666+    ||  1111 ]______________________________________________,'v",
        "v....]3333EM|||||||4444444444444]   MMMMm 11  ]____________                                    v",
        "v....]3333mmm333m||m444444444444]   EEEEc 11  ]____________             ^^^^^^        ^^^^^^   v",
        "v....]3333||33333||4444444444444]   MMMMm 11  ]____________  ]]RR]]RR]] ^B^^B^        ^B^^B^   v",
        "v....]3333333333m||m444444444444]    ||  111  ]____________  ]       l] =H==H=        =H==H=   v",
        "v....]333333333  ||4444444444444]    ||  111  ]____________  +       l] ^X^^X^        ^X^^X^   v",
        "v....]33333333  m||m444m44444444]   m||m 111  ]____________  +        ] ^X^^X^        ^X^^X^   v",
        "v....]333333!   EMM||||||4444444]  11111111   ]____________  ]       <] =H==H=        =H==H=   v",
        "v....]3333!!!   m||m   m44444444+  1111111    ]____________  ]]RR]]RR]] ^X^^X^        ^X^^X^   v",
        "v....]33         || !!!444444444+  111111    b]____________             ^X^^X^        ^X^^X^   v",
        "v....]8 8  !!!!!!!!!!!4444444444]  1111   bbb ]____________          %% =H==H=   %%   =H==H= %%v",
        "v....]PPP  !!!!!!!!!!44444444444]  1111   bbbb]____________  OxxxO   %% ^X^^X^   %%   ^X^^X^ %%v",
        "v....]8 8  !!!!!!!!!444444444444]       b  bbb]____________  OoooO      ^X^^X^        ^X^^X^   v",
        "v....]PPP  !!!!!!444444444444444]]++]]]]]]]]]]]____________  OoooO      =H==H=        =H==H=   v",
        "v....]8 8  !!!!33334444444444444]    ]'''''''''____________  OoooO   /  ^X^^X^        ^X^^X^   v",
        "v....]     !!!333333444444444444]    R'''''''''____________  OoooO      ^X^^X^        ^X^^X^   v",
        "v....]]]]] !!3333333334444444444]    ]'''''''''____________  OoooO      =H==H=        =H==H=   v",
        "v........] !33!33333333444444444]    R'''''''''____________  OOOOO   %% ^X^^X^   %%   ^X^^X^ %%v",
        "v........] 333333333333333333344]    ]'''''''''____________          %% ^X^^X^   %%   ^X^^X^ %%v",
        "v........]333333333333333333333 ]]++]]'''''''''____________             =H==H=        =H==H=   v",
        "v........]]]33333333333333333]]]]              ____________  OxxxO      ^X^^X^        ^X^^X^   v",
        "v......      3333333333333333                  ____________  OoooO      ^X^^X^        ^X^^X^   v",
        "v......       333333333333333                  ____________  OoooO      =H==H=        =H==H=   v",
        "v......      ,___3333333333333_____________________________  OoooO      ^X^^X^        ^X^^X^   v",
        "v......      ,____33333333333______________________________  OoooO      ^X^^X^        ^X^^X^   v",
        "v......      ,_____333333333_______________________________  OoooO      =H==H=        =H==H=   v",
        "v......      ,_____________________________________________  OOOOO      ^X^^X^        ^X^^X^   v",
        "v......      ,_____________________________________________             ^X^^X^        ^X^^X^   v",
        "v......      ,_____________________________________________             =H==H=        =H==H=   v",
        "v......      ,_____________________________________________  `   `      ^X^^X^        ^X^^X^   v",
        "v......      ,_____________________________________________             ^X^^X^        ^X^^X^   v",
        "v......      ,_____________________________________________  `   `      =H==H=        =H==H=   v",
        "v......      ,_____________________________________________             ^X^^X^        ^X^^X^   v",
        "v......      ,_____________________________________________  `   `   %% ^X^^X^   %%   ^X^^X^ %%v",
        "v......      ,_____________________________________________          %% =H==H=   %%   =H==H= %%v",
        "v......                                                      `   `      ^X^^X^        ^X^^X^   v",
        "v......                                                                 ^X^^X^        ^X^^X^   v",
        "v......       ']]R]]++]]]]]]]]]]]]++]]xxxxxx]]]]]                    /  =H==H=        =H==H=   v",
        "v......      '']         #sssssss           ;CCC]            OxxxO      ^X^^X^        ^X^^X^   v",
        "v......      '']  TTT    +                     C]            OoooO      ^X^^X^        ^X^^X^   v",
        "v......      ''] hTTTh   +                     C]            OoooO   %% =H==H=   %%   =H==H= %%v",
        "v......      '']  TTTh   #                     C]            OoooO   %% ^X^^X^   %%   ^X^^X^ %%v",
        "v......      ''] hTTT    #/      m|m      CCCCCC]            OoooO      ^X^^X^        ^X^^X^   v",
        "v......      '']       yy#@e      |             ]            OoooO      =H==H=        =H==H=   v",
        "v......       ']]]]]]]]]]]ee     mpm            ]            OOOOO      ^X^^X^        ^X^^X^   v",
        "v......                  ]        |             ]                       ^X^^X^        ^X^^X^   v",
        "v......                  +       mMm  m  FxFEFxF]                       =H==H=        =H==H=   v",
        "v......                  +        ||||MPPF FPF F]            `   `      ^X^^X^        ^X^^X^   v",
        "v.......                 ]8888        m  FFFMFFF]                       ^X^^X^        ^X^^X^   v",
        "v........................]]]]]]]]]]]]]]]]]]]]]]]]            `   `      =H==H=        =H==H=   v",
        "v................................................                       ^X^^X^        ^X^^X^   v",
        "v................................................            `   `      ^X^^X^        ^X^^X^   v",
        "v................................................                       =H==H=        =H==H=   v",
        "v................................................            `   `      ^X^^X^        ^X^^X^   v",
        "v................................................                       ^X^^X^        ^X^^X^   v",
        "v................................................                       =H==H=        =H==H=   v",
        "v................................................                       ^X^^X^        ^X^^X^   v",
        "v................................................                       ^X^^X^        ^X^^X^   v",
        "vvvvvvvvvvvvvvvvvvvvvvvvvvvvvvvvvvvvvvvvvvvvvvvvvvvvvvvvvvvvvvvvvvvvvvv =H==H= vvvvvv =H==H= vvv"
      ],
      "terrain": {  },
      "furniture": {  },
      "palettes": [ "steel_mill_slag_palette" ],
      "place_monsters": [
        { "monster": "GROUP_STEEL_MILL", "x": [ 1, 22 ], "y": [ 1, 22 ], "chance": 4 },
        { "monster": "GROUP_STEEL_MILL", "x": [ 25, 46 ], "y": [ 1, 22 ], "chance": 4 },
        { "monster": "GROUP_STEEL_MILL", "x": [ 49, 70 ], "y": [ 1, 22 ], "chance": 4 },
        { "monster": "GROUP_STEEL_MILL", "x": [ 73, 94 ], "y": [ 1, 22 ], "chance": 4 },
        { "monster": "GROUP_STEEL_MILL", "x": [ 1, 22 ], "y": [ 25, 46 ], "chance": 4 },
        { "monster": "GROUP_STEEL_MILL", "x": [ 25, 46 ], "y": [ 25, 46 ], "chance": 4 },
        { "monster": "GROUP_STEEL_MILL", "x": [ 49, 70 ], "y": [ 25, 46 ], "chance": 4 },
        { "monster": "GROUP_STEEL_MILL", "x": [ 73, 94 ], "y": [ 25, 46 ], "chance": 4 },
        { "monster": "GROUP_STEEL_MILL", "x": [ 1, 22 ], "y": [ 49, 70 ], "chance": 4 },
        { "monster": "GROUP_STEEL_MILL", "x": [ 25, 46 ], "y": [ 49, 70 ], "chance": 4 },
        { "monster": "GROUP_STEEL_MILL", "x": [ 49, 70 ], "y": [ 49, 70 ], "chance": 4 },
        { "monster": "GROUP_STEEL_MILL", "x": [ 73, 94 ], "y": [ 49, 70 ], "chance": 4 },
        { "monster": "GROUP_STEEL_MILL", "x": [ 1, 22 ], "y": [ 73, 94 ], "chance": 4 },
        { "monster": "GROUP_STEEL_MILL", "x": [ 25, 46 ], "y": [ 73, 94 ], "chance": 4 },
        { "monster": "GROUP_STEEL_MILL", "x": [ 49, 70 ], "y": [ 73, 94 ], "chance": 4 },
        { "monster": "GROUP_STEEL_MILL", "x": [ 73, 94 ], "y": [ 73, 94 ], "chance": 4 },
        { "monster": "GROUP_STEEL_MILL", "x": [ 1, 22 ], "y": [ 97, 118 ], "chance": 4 },
        { "monster": "GROUP_STEEL_MILL", "x": [ 25, 46 ], "y": [ 97, 118 ], "chance": 4 },
        { "monster": "GROUP_STEEL_MILL", "x": [ 49, 70 ], "y": [ 97, 118 ], "chance": 4 },
        { "monster": "GROUP_STEEL_MILL", "x": [ 73, 94 ], "y": [ 97, 118 ], "chance": 4 }
      ]
    }
  }
]
