[
  {
    "type": "mapgen",
    "update_mapgen_id": "mx_rock_formation",
    "object": {
      "rows": [
        "   -                    ",
        "  -#-               --  ",
        "   - -            -     ",
        "    --   --         -   ",
        "        -#-             ",
        "       --#-    ----     ",
        "      --##-------#---   ",
        "     --############--   ",
        "    ----#--- --####--   ",
        "     - ---  --##-----   ",
        "   -##-      ----       ",
        "    -         - -       ",
        "         #-     -       ",
        "  --# -                 ",
        "   -                    ",
        "            -           ",
        "           -#           ",
        "                        ",
        "                        ",
        "                        ",
        "         -              ",
        "                  --#   ",
        "                        ",
        "                        "
      ],
      "flags": [ "ERASE_ALL_BEFORE_PLACING_TERRAIN" ],
      "terrain": { "-": [ [ "t_dirt_rocky", 5 ], "t_moss", "t_dirt" ], "#": [ [ "t_dirt_rocky", 5 ], "t_moss" ] },
      "furniture": {
        "-": [ [ "f_rubble_rock", 3 ], "f_boulder_small", [ "f_null", 10 ] ],
        "#": [ "f_boulder_small", "f_boulder_medium", "f_boulder_large", "f_rubble_rock", "f_null" ]
      }
    }
  },
  {
    "type": "mapgen",
    "update_mapgen_id": "mx_rock_formation_2",
    "object": {
      "rows": [
        "                        ",
        "         #-             ",
        "      -   -      #-     ",
        "                        ",
        "   --           -       ",
        "                        ",
        "        -------         ",
        "      ----####----      ",
        "     ------########--   ",
        "       ------##-----    ",
        "          --##---       ",
        "      -------#####-     ",
        "           --##--       ",
        "       --  --           ",
        "   ---------##--        ",
        "       ----##------     ",
        "       -##-------       ",
        "      ##---    --       ",
        "       --       -       ",
        "         --             ",
        "    #                   ",
        "                 --     ",
        "    -                   ",
        "                        "
      ],
      "flags": [ "ERASE_ALL_BEFORE_PLACING_TERRAIN" ],
      "terrain": { "-": [ [ "t_dirt_rocky", 5 ], "t_moss", "t_dirt" ], "#": [ [ "t_dirt_rocky", 5 ], "t_moss" ] },
      "furniture": {
        "-": [ [ "f_rubble_rock", 3 ], "f_boulder_small", [ "f_null", 10 ] ],
        "#": [ "f_boulder_small", "f_boulder_medium", "f_boulder_large", "f_rubble_rock", "f_null" ]
      }
    }
  },
  {
    "type": "mapgen",
    "update_mapgen_id": "mx_rock_formation_3",
    "object": {
      "rows": [
        "                        ",
        "                        ",
        "               -        ",
        "                        ",
        "                        ",
        "     --                 ",
        "         ------         ",
        "       -----#----       ",
        "      ----#####---      ",
        "       ----###--        ",
        "          --##---       ",
        "      ----###-----      ",
        "         ---##---       ",
        "       ----#-----       ",
        "     ----#####--        ",
        "       ----##----       ",
        "       --------         ",
        "        ---             ",
        "       --    ##-        ",
        "         --   -         ",
        "                   -    ",
        "      #                 ",
        "     -                  ",
        "                        "
      ],
      "flags": [ "ERASE_ALL_BEFORE_PLACING_TERRAIN" ],
      "terrain": { "-": [ [ "t_dirt_rocky", 5 ], "t_moss", "t_dirt" ], "#": [ [ "t_dirt_rocky", 5 ], "t_moss" ] },
      "furniture": {
        "-": [ [ "f_rubble_rock", 3 ], "f_boulder_small", [ "f_null", 10 ] ],
        "#": [ "f_boulder_small", "f_boulder_medium", "f_boulder_large", "f_rubble_rock", "f_null" ]
      }
    }
  }
]
